
NO ./texture/tnt.xpm

SO ./texture/floor.xpm

WE ./texture/wall.xpm

EA ./texture/test.xpm

F 185,185,185




C 0,0,0


11111111111111111111111111111
10000000000000000000000000001
10000000000000000000000000001
10000000000010000000000000001
10000000000000000000000000001
10000000000000000000000000001
10000000000010100000000000001
1000000000000000N000000000001
10000000000000000000000000001
10000000000000000000000000001
10000000000000000000000000001
10000000000000000000000000001
11111111111111111111111111111